.............
.............
..+---+---+..
..#...|...|..
..W...D...|..
..|...|...|..
..+---+-D-+..
.............
.............    